5 5
0 0 0 0 0
0 1 1 Q 1
A 1 0 0 0
0 0 0 1 1
1 0 0 0 1